############
#      O   #
#     P ####
#          #
#######    #
#    ##    #
#    ##    #
#          #
#  O    XX #
#      #   #
############
